Cree le 28/08/2024
Ca fait 9 jours

MONSTER : Screech, Rush, Eyes, Statue, Hide, Seek, Figure;
MEUBLE : Placard, Bureau, Openable door;
CONSUMABLE : Flashlight, Crowbar, Medicine, Monster Reborn;


   11111
  10001
 111111111
100000S011
101000000011
100101000001
11100111111
  11111111
  11111111111
  1111111111
  1111111111
  111111111
  11111111
  11111111111
  1111111111
  1111111111
  111111111
  11111111
  11111111111
  1111111111
  1111111111
  111111111
  11111111
  11111111111
  1111111111
  1111111111
  111111111


























































































