Cree le 28/08/2024
Ca fait 11 jours

MONSTER : Screech, Rush, Eyes, Statue, Hide, Seek, Figure;
MEUBLE : Placard, Bureau, Openable door;
CONSUMABLE : Flashlight, Crowbar, Medicine, Monster Reborn;


 1111 11111111
 1000100000001
 1000100E00001
 100000000111
  110010000001
 1000010000001
 11111 1111111
