Cree le 28/08/2024
Ca fait 11 jours

MONSTER : Screech, Rush, Eyes, Statue, Hide, Seek, Figure;
MEUBLE : Placard, Bureau, Openable door;
CONSUMABLE : Flashlight, Crowbar, Medicine, Monster Reborn;

NO ./MUR.xpm
SO ./MUR.xpm

WE ./MUR.xpm
EA ./MUR.xpm

F 211, 211, 211
C 105, 105, 105

    111
    1S1
11111011111
10000000001
10000000001
10000000001
11111111111
