Cree le 28/08/2024
Ca fait 11 jours

MONSTER : Screech, Rush, Eyes, Statue, Hide, Seek, Figure;
MEUBLE : Placard (p), Bureau (b), Openable door (2-3);
CONSUMABLE : Flashlight, Crowbar, Medicine, Monster Reborn;

NO ./MUR.xpm
SO ./MUR.xpm

WE ./MUR.xpm
EA ./MUR.xpm

F 168, 89, 50
C 168, 89, 50

(1) Wall
(0) Space
(W,E,S,N) Player Spawn
(2) Closed door
(3) Opened door
(4) Automatic door
(5) Closet
(d) Drawer
(k) Drawer with key

    111
    1S1
  11101111
  10000001111111111111111111111111111111111111111111111111111111111111111111111111111111111111111111111111111111111
  10000000000000000000000000000000000000000000000000000000000000000000000000000000000000000000000000000000000000001
  10000001111111111111111111111111111111111111111111111111111111111111111111111111111111111111111111111111111111111
  11011111
  1000001
  1000001
  1000001
  1000001
  1111111
