Cree le 28/08/2024
Ca fait 11 jours

MONSTER : Screech, Rush, Eyes, Statue, Hide, Seek, Figure;
MEUBLE : Placard, Bureau, Openable door;
CONSUMABLE : Flashlight, Crowbar, Medicine, Monster Reborn;


 1111 11111111
 1010100000001
 10101110000E1
 100000000111
 100000000001
 100000000001
 100000000001
 100000000001
 100000000001
 100000000001
 100000000001
 100000000001
 100000000001
 100000000001
 100000000001
 100000000001
 100000000001
 100000000001
 100000000001
 100000000001
 100000000001
 100000000001
 100000000001
 100000000001
 100000000001
 100000000001
 100000000001
 100000000001
 100000000001
 100000000001
 100000000001
 100000000001
 100000000001
 100000000001
 100000000001
 100000000001
 100000000001
 100000000001
 100000000001
 100000000001
 100000000001
 100000000001
 100000000001
 100000000001
 100000000001
 100000000001
 100000000001
 100000000001
 100000000001
 100000000001
 100000000001
 100000000001
 100000000001
 100000000001
 100000000001
 100000000001
 100000000001
 100000000001
 100000000001
 100000000001
 100000000001
 100000000001
 100000000001
 100000000001
 100000000001
 100000000001
 100000000001
 100000000001
 100000000001
 100000000001
 100000000001
 100000000001
 100000000001
 100000000001
 100000000001
 100000000001
 100000000001
 100000000001
 100000000001
 100000000001
 100000000001
 100000000001
 100000000001
 100000000001
 100000000001
 100000000001
 100000000001
 100000000001
 100000000001
 100000000001
 100000000001
 100000000001
 100000000001
 100000000001
 100000000001
 100000000001
 100000000001
 100000000001
 100000000001
 100000000001
 100000000001
 100000000001
 100000000001
 100000000001
 100000000001
 100000000001
 100000000001
 100000000001
 100000000001
 100000000001
 100000000001
 100000000001
 100000000001
 100000000001
 100000000001
 100000000001
 100000000001
 100000000001
 100000000001
 100000000001
 100000000001
 100000000001
 100000000001
 100000000001
 100000000001
 100000000001
 100000000001
 100000000001
 100000000001
 100000000001
 100000000001
 100000000001
 100000000001
 100000000001
 100000000001
 100000000001
 100000000001
 100000000001
 100000000001
 100000000001
 100000000001
 100000000001
 100000000001
 100000000001
 100000000001
 100000000001
 100000000001
 100000000001
 100000000001
 100000000001
 100000000001
 100000000001
 100000000001
 100000000001
 100000000001
 100000000001
 100000000001
 100000000001
 100000000001
 100000000001
 100000000001
 100000000001
 100000000001
 100000000001
 100000000001
 100000000001
 100000000001
 100000000001
 100000000001
 100000000001
 100000000001
 100000000001
 100000000001
 100000000001
 100000000001
 100000000001
 100000000001
 100000000001
 100000000001
 100000000001
 100000000001
 100000000001
 100000000001
 100000000001
 100000000001
 100000000001
 100000000001
 100000000001
 100000000001
 100000000001
 100000000001
 100000000001
 100000000001
 100000000001
 100000000001
 100000000001
 100000000001
 100000000001
 100000000001
 100000000001
 100000000001
 100000000001
 100000000001
 100000000001
 100000000001
 100000000001
 100000000001
 100000000001
 100000000001
 100000000001
 100000000001
 100000000001
 100000000001
 100000000001
 100000000001
 100000000001
  110010000001
 1000010000001
 11111 1111111
