Cree le 28/08/2024
Ca fait 1 mois, 26 jours

MONSTER : rush(r, u), screech (e, h), SCP173(s, c), davli;
MEUBLE : Placard (p), Openable door (2-3);

NO ./xpms/Wall.xpm
SO ./xpms/Wall.xpm
WE ./xpms/Wall.xpm
EA ./xpms/Wall.xpm

F 43, 35, 48
C 84, 51, 38

(1) Wall
(0) Space
(W,E,S,N) Player Spawn
(2) Closed door horizontal
(3) Closed door vertical
(6) Reopenable door
(p) Closet
(D) Final Boss

    111
    1S1
  11161111
  100000p111111111111111
  1p000003000000000000001
  1000p00111111111111111
   121111
  1000p01
  1000001
  1000001
  1000001
  1000001
  10000p1
  1000001
  1000001
   121111111111111
  10000003000000001
  100000111000000p1
  1000001 100000001
  10000011100000001
 110000000100000001
1000000111100000001
 11211111 100000001
 111      100000001
           11111211
              100001
              100001
              100001
              1p0001
              100001
              100001
              1000p1
              100001
              100001
              1121111111
              1001003001
              1000001001
              1000001001
              1000001001
              1112110001
              1111110001
                    1101
                 1111101
                 10000001
          1111111100000011
         100000000000000031
          1011111100000011
          121    10000001
          101    10000001
          101     1111101
     11111101         101
     10000001         101
     10011101         121
     10000001         121  
     10000011         111
     11011111
      101
      101111111111111111
      121100000000000001
      100101111111111111
      100101
      100001
      10011
      1001
      1001
      1001
      1001
      1001
      1001
      1001
      1001
      10p1
      1001
      1001
      1001
   111101111
   100121001
   100000001
   1p0000001
   1000000p1
   100000001
   100p00001
   111111121
         101
         1001
         101
        1001
         101
         1011
         10001
         1011
        10001
         1011
         121
      111101111
      100000001
      1000000011111
      1p00000000001
      1000000011101
  1111100000001 10111
 100000000000p1 10001
  1111100000001 11101
      100p00001   121
      111121111  11011
         101    1000001
         101    1000001
         111    1000001
            11111000001
           103000011101
            11110000001
               100000011111
               1000000000001
               1111111111101
                       1112111
                       1010101
                       1000001
                       1000001
                       1000001
                       1000001
                       10000p1
                       1p00001
                       1000001
                       1000001
                       1000001
                       1000001
                       1000001
                       1000001
                    1111112111111
                    1000000000001
                    1000000000001
                    1000000000001
                    1000000000001
                    1000000000001
                    1000000000001
                    1000000000001
                    100000D000001
                    1000000000001
                    1000000000001
                    1000000000001
                    1111111111111